NewGame = "New Game"
Continue = "Continue"
Options = "Options"
Exit = "Exit"
Multiplayer = "Multiplayer"
Music = "Music:"
SoundEffects = "Sound Effects:"
Language = "Language:"
Back = "Back"
Fullscreen = "Fullscreen:"
English = "English"
French = "French"
On = "On"
Off = "Off"
Life = "Life"
Gold = "Gold"
Income = "Income"
Opponent = "Opponent"
Attack = "Attack"
Cooldown = "Attack speed"
Cout = "Cost"
Range = "Range"
GAMEOVER = "GAME OVER"
Win = "YOU WON"
Retry = "Retry"
BackToMainMenu = "Back to Main Menu"
Next = "Next"
MacStory1 = "A long time ago, in the late 70's, a great mind had the idea of creating\nan easy to use personal computer and operating system. He named it Macintosh.\nThis computer line continued until today and became one of the most\npopular computers in the world. As technology advanced, hackers tried\nto create viruses for the operating system which had a great security.\nThey never succeeded."
MacStory2 = "All viruses eliminated, you won the game.\nJust kidding, starting the game with Windows."
WindowsStory = "A long time ago, in the mid-80's, engineers have created the operating\nsystem that would change the future of the world: Windows. This\noperating system is now being used by more then the half of\ncomputers. But there was thing the creators never tought about: viruses."
ChooseOS = "Choose you OS"
OwnServer = "The server is on my computer"
NotOwnServer = "Connect to another computer on network"
Retry = "Retry"
ChangeServer = "Change Server"
MainMenu = "Main Menu"
Disconnected = "You'll Catch a Virus - Disconnected"
ConnectToServer = "You'll Catch a Virus - Connect to Server"
Dc = "Your partner disconnected"
ServerDown = "Server has been shut down"
LanGameStarts = "The Game Starts!"
HighScore = "High Scores"
SaveHighScore = "Save High Score"
YouScored = "You scored"
Resume = "Resume Game"
ReturnToMainMenu = "Return to Main Menu"
Cancel = "Cancel"