NewGame = "Nouvelle Partie"
Continue = "Continuer"
Options = "Options"
Exit = "Quitter"
Multiplayer = "Multijoueur"
Music = "Musique:"
SoundEffects = "Effets Speciaux:"
Language = "Langue:"
Back = "Retour"
Fullscreen = "Plein Ecran:"
English = "Anglais"
French = "Francais"
On = "Oui"
Off = "Non"
Life = "Vies"
Gold = "Argent"
Income = "Revenu"
Attack = "Attaque"
Cooldown = "Vitesse d'attaque"
Cout = "Cout"
Range = "Portee"
GAMEOVER = "VOUS AVEZ PERDU"
Retry = "Reessayer"
BackToMainMenu = "Retour au Menu Principal"
Next = "Suivant"
MacStory1 = "Il y a longtemps, dans la fin des annees 70, un grand esprit a eu l'idee de creer\nun outil facile a utiliser : l'ordinateur personnel et le systeme d'exploitation.\nIl l'a appele Macintosh. Cette marque  d'ordinateur a continue jusqu'a aujourd'hui\net est devenu l'une des plus populaires dans le monde. En tant que technologie\nde pointe, les pirates ont essaye pour creer des virus pour le systeme d'exploitation\nqui a eu une grande securite. Ils n'ont jamais reussi."
MacStory2 = "Tous les virus ont ete elimines. Vous avez gagne !\nTreve de plaisanteries, commencons une partie avec Windows."
WindowsStory = "Il y a longtemps, au milieu des annees 80, les ingenieurs ont cree le systeme\nd'exploitation qui allait changer l'avenir du monde: Windows. Ce\nsysteme d'exploitation est maintenant utilise par plus de la moitie des\nordinateurs. Mais il y avait des choses que les createurs n'avaient jamais pense: \nles virus."
ChooseOS = "Choisissez votre OS"
OwnServer = "Le serveur est sur mon ordinateur"
NotOwnServer = "Connecter à un autre ordinateur sur le réseau"
ChangeServer = "Changer de Serveur"
MainMenu = "Menu Principal"
Disconnected = "You'll Catch a Virus - Déconnexion"
ConnectToServer = "You'll Catch a Virus - Connection Serveur"
Dc = "Votre partenaire s'est déconnecté"
ServerDown = "Le serveur à été arreté"
LanGameStarts = "Le jeu commence!"
HighScore = "Scores"
SaveHighScore = "Sauvagerde de Score"
YouScored = "Vous avez fait"
Resume = "Retour au Jeu"
ReturnToMainMenu = "Retour au Menu Principal"
Cancel = "Annuler"